# # # # # # # # # #
# M . * * . . . . #
# . s . . . m . . #
# * * . # . * * . #
# * # . . . . * . #
# * * . . * * * . #
# . . . b . . . . #
# . . * * * . . . #
# . . . . . . . . #
# # # # # # # # # #