# # # # # # # # # #
# . . . * * . . . #
# . . s . . . s . #
# . * * . . . * . #
# . * # . . . * . #
# . * * . . * * . #
# . . . . s . . . #
# . . . * * * . . #
# M . . . . . . . #
# # # # # # # # # #