# # # # # # # # # #
# . . . * * . . . #
# . . s . . . m . #
# . * * . . . * . #
# . * # . . . * . #
# . * * . . * * . #
# . . . . b . . . #
# . . . * * * . . #
# M . . . . . . . #
# # # # # # # # # #