B B B B B B B B B B
B n n n s s n n n B
B n 1 s n s n 2 n B
B s s s n s s s n B
B n s B n n n s n B
B n s s s s s s n B
B n n n s 3 s n n B
B n n n s s s n n B
B n n n n n n n n B
B B B B B B B B B B
